WWWWWWWWWWWWWWWWWWWWWWWWWWWWWWWW
WOWOOWWWOOOOWOOOOOOOWOOOOOWOWOOW
WOWWOOOOOWWOOWWWOWWOWWOWWOWOOOWW
WOOWOWWWWWWWOOOWOWWOWWOWOOWOWOWW
WWOWOOOWOOWOOWOWOOWOWOOWOWWOWOOW
WOOWWWOWOWWOWWOWWOWOOOWWOOWOWWWW
WOWOOOOWOOOOOWOWWOWWWOOOWOWOOOWW
WOWOWWWWWWWWWWOOWOOOWWWWWOWWWOOW
WOOOWWOOOOOOOOWOWWWOOOOOWOOOWWOW
WWWWOOOWWWWWWWWOOOOWWWWOWWWOOWOW
WOOWOWOWOWOOOOOWWWOWOOOOWOWWOWOW
WWOWOWOOOWOWOWWWWOOWWWOWWOOWOWOW
WOOWOWWWWOOWOWOOOOWWWOOWWOWWOOOW
WOWWOWWOOOWWOOOWWWWOOOWOOOWWWOWW
WOOWOWOOWWWWWWWWWOOOWWWWWOWOOOWW
WWOWOWOWOOOOOOOWOOWOOWOOOOWOWWOW
WOOOOWOWWWOWWWOWWWWWOWWWOWWOWWOW
WOWOWWOOOWOOOWOOOOOWOWOOOWOOWWOW
WWWOOOWWOOWWOWWWWWOOOWWOWWOWWOOW
WOOOWOWWWOOWOOWOOWWWWOOOOOOOOOWW
WOWWWOWWWWOWWOOOWWOWWOWWWWWWWOOW
WOOOWWOOOWOOOWWOOWOOOOWOOOOWWWOW
WOWOWWOWOWWWOWOWOOWWWWOOWWOWOOOW
WOWOWOOWOOOWOWOWWOOWOOOWWWOWOWWW
WOWOOOWOOWWWOWOWWWOOOWOOWOOWOWOW
WOWWWWWOWOOOOWOWWWWWWWWOWOWWOOOW
WOWOWOOOWWWOWWOOOOWOOOWOWOOWWWOW
WOOOWOWOOWOOWWOWWOOOWOOWWWOOOWOW
WWOWWOWWWWOWOOOOOWWWWWOOOWOWOWOW
WOOOWOOWOOOWOWWWWWOOOWWWOWWWOWOW
WOWOWWOOOWOOOWOOOOOWOOOOOOOOOWOW
WWWWWWWWWWWWWWWWWWWWWWWWWWWWWWWW
